########################
#......................#
####.....####..........#
##......##..##.........#
#......................#
#......................#
#......................#
##########...###########